{
	"name": "Route 10",
	"source": "Pokemon Black White",
	"reference" : "https://www.youtube.com/watch?v=khsvL-GTU6o",
	"image": "images/pokemon_bw.jpg",
	"imageWidth": 260,
	"imageHeight": 195,
	"song": "Pokemon_BlackWhite_Route10.mp3",
	"timeTravel": 3,
	"wait": 0,
	"period": 1715,
	"content": [
		[1, 0, 0, 0, 0, 0, 0, 0],
		[1, 0, 0, 0, 0, 0, 0, 0],
		[1, 0, 0, 0, 0, 0, 0, 0],
		[1, 0, 0, 0, 0, 0, 0, 0],
		[1, 0, 0, 0, 0, 0, 0, 0],
		[1, 0, 0, 0, 0, 0, 1, 0],
		[1, 0, 0, 0, 0, 0, 1, 0],
		[1, 0, 0, 0, 0, 0, 1, 0],

		[1, 0, 0, 1, 0, 0, 1, 0],
		[1, 0, 0, 1, 0, 0, 1, 0],
		[1, 0, 0, 1, 0, 0, 1, 0],
		[1, 0, 0, 1, 0, 0, 0, 0],

		[1, 0, 0, 0, 0, 0, 0, 0],
		[1, 0, 0, 0, 0, 0, 1, 0],
		[1, 0, 0, 0, 0, 0, 1, 0],
		[1, 0, 0, 0, 0, 0, 1, 0],

		[1, 0, 0, 1, 0, 0, 1, 0],
		[1, 0, 0, 1, 0, 0, 1, 0],
		[1, 0, 0, 1, 0, 0, 1, 0],
		[1, 0, 0, 1, 0, 0, 0, 0],

		[1, 0, 0, 1, 0, 0, 1, 0],
		[1, 0, 0, 1, 0, 0, 1, 0],
		[1, 0, 0, 1, 0, 0, 1, 0],
		[1, 0, 0, 1, 0, 0, 0, 0],	

		[1, 0, 0, 1, 0, 0, 1, 0],
		[1, 0, 0, 1, 0, 0, 1, 0],
		[1, 0, 0, 1, 0, 0, 1, 0],
		[1, 0, 0, 0, 0, 0, 1, 0],

		[1, 0, 0, 1, 0, 0, 1, 0],
		[1, 0, 0, 1, 0, 0, 1, 0],
		[1, 0, 0, 1, 0, 0, 1, 0],
		[1, 0, 0, 1, 0, 0, 0, 0],

		[1, 0, 0, 1, 0, 0, 1, 0],
		[1, 0, 0, 1, 0, 0, 1, 0],
		[1, 0, 0, 0, 0, 0, 0, 0],
		[0, 0, 0, 0, 0, 0, 1, 0],
		[1, 0, 0, 0, 0, 0, 0, 0],
		[0, 0, 0, 0, 0, 0, 1, 0],	
		[1, 0, 0, 0, 0, 0, 0, 0],
		[0, 0, 0, 0, 0, 0, 0, 0],

		[0, 0, 0, 0, 0, 0, 0, 0],
		[0, 0, 0, 0, 0, 0, 0, 0],
		[0, 0, 0, 0, 0, 0, 0, 0],
		[0, 0, 0, 0, 0, 0, 0, 0],
		[0, 0, 0, 0, 0, 0, 0, 0]
	]
}