{
	"name": "His Theme",
	"source": "Undertale",
	"reference" : "https://www.youtube.com/watch?v=E0993FmdoNI",
	"image": "images/undertale.jpg",
	"imageWidth": 250,
	"imageHeight": 250,
	"song": "undertale_musicBox.mp3",
	"timeTravel": 3,
	"wait": 0,
	"period": 2675,
	"content": [
		[1, 0, 0, 0, 3, 0, 0, 0, 2, 0, 0, 3, 0, 0, 3, 0],
		[0, 0, 1, 0, 0, 0, 0, 0, 2, 0, 0, 3, 0, 0, 3, 0],
		[1, 0, 0, 0, 3, 0, 0, 0, 2, 0, 0, 3, 0, 0, 3, 0],
		[0, 0, 1, 0, 0, 0, 0, 0, 2, 0, 0, 1, 0, 0, 1, 0],
		[1, 0, 0, 0, 3, 0, 0, 0, 2, 0, 0, 3, 0, 0, 3, 0],
		[0, 0, 1, 0, 0, 0, 0, 0, 2, 0, 0, 3, 0, 0, 3, 0],
		[1, 0, 0, 0, 3, 0, 0, 0, 2, 0, 0, 3, 0, 0, 3, 0],
		[0, 0, 1, 0, 0, 0, 0, 0, 2, 0, 0, 1, 0, 0, 1, 0],
		[1, 0, 0, 0, 3, 0, 0, 0, 2, 0, 0, 3, 0, 0, 3, 0],
		[0, 0, 1, 0, 0, 0, 0, 0, 2, 0, 0, 3, 0, 0, 3, 0],
		[1, 0, 0, 0, 3, 0, 0, 0, 2, 0, 0, 3, 0, 0, 3, 0],
		[0, 0, 1, 0, 0, 0, 0, 0, 2, 0, 0, 1, 0, 0, 1, 0],
		[1, 0, 0, 0, 3, 0, 0, 0, 2, 0, 0, 3, 0, 0, 3, 0],
		[0, 0, 1, 0, 0, 0, 0, 0, 2, 0, 0, 3, 0, 0, 3, 0],
		[1, 0, 0, 0, 3, 0, 0, 0, 2, 0, 0, 3, 0, 0, 3, 0],
		[0, 0, 1, 0, 0, 0, 0, 0, 2, 0, 0, 1, 0, 0, 1, 0],
		[1, 0, 0, 0, 3, 0, 0, 0, 2, 0, 0, 3, 0, 0, 3, 0],
		[0, 0, 1, 0, 0, 0, 0, 0, 2, 0, 0, 3, 0, 0, 3, 0],
		[1, 0, 0, 0, 3, 0, 0, 0, 2, 0, 0, 3, 0, 0, 3, 0],
		[0, 0, 1, 0, 0, 0, 0, 0, 2, 0, 0, 1, 0, 0, 1, 0],
		[1, 0, 0, 0, 3, 0, 0, 0, 2, 0, 0, 3, 0, 0, 3, 0],
		[0, 0, 1, 0, 0, 0, 0, 0, 2, 0, 0, 3, 0, 0, 3, 0],
		[1, 0, 0, 0, 3, 0, 0, 0, 2, 0, 0, 3, 0, 0, 3, 0],
		[0, 0, 1, 0, 0, 0, 0, 0, 2, 0, 0, 1, 0, 0, 1, 0]
	]
}