{
	"name": "Battle",
	"source": "Final Fantasy I",
	"reference" : "https://www.youtube.com/watch?v=XhjnG7tU6fo",
	"image": "images/final_fantasy.jpg",
	"imageWidth": 300,
	"imageHeight": 215,
	"song": "Final_Fantasy_I_Battle_Remake.mp3",
	"timeTravel": 2.5,
	"wait": 0,
	"period": 1500,
	"content": [
		[0, 0, 0, 0, 0, 0, 0, 0],
		[0, 0, 0, 0, 0, 0, 0, 0],

		[3, 0, 1, 0, 0, 0, 1, 0],
		[1, 0, 1, 0, 1, 0, 1, 0],
		[3, 0, 1, 0, 0, 0, 3, 0],
		[1, 0, 0, 0, 0, 0, 0, 0],
		[3, 0, 1, 0, 0, 0, 1, 0],
		[1, 0, 1, 0, 1, 0, 1, 0],
		[3, 0, 1, 0, 0, 0, 3, 0],
		[1, 0, 0, 0, 0, 0, 0, 0],

		[0, 0, 2, 0, 0, 2, 0, 0],
		[1, 0, 0, 0, 0, 0, 0, 0],
		[0, 0, 2, 0, 0, 2, 0, 0],
		[1, 0, 0, 0, 0, 0, 0, 0],

		[0, 0, 1, 0, 0, 1, 0, 0],
		[1, 0, 0, 1, 0, 0, 1, 0],
		[0, 0, 1, 0, 0, 1, 0, 0],
		[1, 0, 0, 1, 0, 0, 1, 0],	
		[0, 0, 1, 0, 0, 1, 0, 0],
		[1, 0, 0, 1, 0, 0, 1, 0],
		[0, 0, 1, 0, 0, 1, 0, 0],
		[1, 0, 0, 1, 0, 0, 1, 0],

		[1, 0, 1, 0, 1, 0, 1, 0],
		[1, 0, 1, 0, 1, 0, 1, 0],
		[3, 0, 0, 1, 0, 1, 0, 1],
		[1, 0, 1, 0, 1, 0, 1, 0],
		[3, 0, 0, 1, 0, 1, 0, 1],
		[1, 0, 3, 0, 3, 0, 3, 0],

		[3, 0, 1, 0, 0, 0, 1, 0],
		[1, 0, 1, 0, 1, 0, 1, 0],
		[3, 0, 1, 0, 0, 0, 3, 0],
		[1, 0, 0, 0, 0, 0, 0, 0],
		[3, 0, 1, 0, 0, 0, 1, 0],
		[1, 0, 1, 0, 1, 0, 1, 0],
		[3, 0, 1, 0, 0, 0, 3, 0],
		[1, 0, 0, 0, 0, 0, 0, 0],	

		[0, 0, 2, 0, 0, 2, 0, 0],
		[1, 0, 0, 0, 0, 0, 0, 0],
		[0, 0, 2, 0, 0, 2, 0, 0],
		[1, 0, 0, 0, 0, 0, 0, 0],		

		[0, 0, 1, 0, 0, 1, 0, 0],
		[1, 0, 0, 1, 0, 0, 1, 0],
		[0, 0, 1, 0, 0, 1, 0, 0],
		[1, 0, 0, 1, 0, 0, 1, 0],	
		[0, 0, 1, 0, 0, 1, 0, 0],
		[1, 0, 0, 1, 0, 0, 1, 0],
		[0, 0, 1, 0, 0, 1, 0, 0],
		[1, 0, 0, 1, 0, 0, 1, 0],	

		[1, 0, 1, 0, 1, 0, 1, 0],
		[1, 0, 1, 0, 1, 0, 1, 0],
		[3, 0, 0, 1, 0, 1, 0, 1],
		[1, 0, 1, 0, 1, 0, 1, 0],
		[3, 0, 0, 1, 0, 1, 0, 1],
		[1, 0, 3, 0, 3, 0, 3, 0],

		[0, 0, 0, 0, 0, 0, 0, 0],
		[0, 0, 0, 0, 0, 0, 0, 0]
	]
}