{
	"name": "Theme Song (Night)",
	"source": "Tower of Saviors",
	"reference" : "https://www.youtube.com/watch?v=rvs8MYdgL0U&list=PL1dxhe0ruOVZ23k3kT586Im203413MQ5S&index=1",
	"image": "images/Tower_of_Saviors.jpg",
	"imageWidth": 320,
	"imageHeight": 180,
	"song": "Tower_of_Saviors.mp3",
	"timeTravel": 3,
	"wait": 0,
	"period": 2500,
	"content": [
		[0, 0, 0, 0, 0, 0, 0, 1],
		[1, 1, 1, 1, 1, 0, 0, 1],
		[1, 1, 1, 1, 1, 0, 0, 1],
		[1, 0, 3, 0, 1, 0, 3, 0],
		[1, 0, 1, 3, 1, 0, 0, 1],
		[1, 0, 1, 0, 1, 0, 0, 1],
		[1, 0, 0, 3, 1, 0, 0, 1],
		[1, 1, 1, 1, 1, 0, 0, 1],
		[1, 1, 3, 0, 1, 0, 0, 0],

		[0, 0, 0, 0, 0, 0, 0, 0, 0, 1, 0, 0, 0, 0, 0, 0, 0, 3, 0, 0, 0, 0, 0, 0, 0, 0, 0, 0, 0, 0, 0, 0],
		[0, 0, 3, 0, 0, 0, 0, 0, 0, 0, 0, 0, 0, 0, 0, 0, 0, 0, 3, 0, 0, 0, 0, 0, 0, 0, 0, 0, 0, 0, 0, 0],
 		[0, 3, 0, 0, 0, 0, 0, 0, 0, 0, 0, 0, 0, 0, 0, 0, 0, 3, 0, 0, 0, 0, 0, 0, 0, 0, 0, 0, 0, 0, 0, 0],
		[3, 0, 0, 0, 0, 0, 0, 0, 0, 0, 0, 0, 0, 0, 0, 0, 1, 0, 0, 0, 0, 0, 0, 0, 1, 0, 0, 0, 0, 0, 0, 0],
		[1, 0, 0, 0, 0, 0, 0, 0, 0, 0, 0, 0, 0, 0, 0, 0, 0, 3, 0, 0, 0, 0, 0, 0, 0, 0, 0, 0, 0, 0, 0, 0],
		[3, 0, 0, 0, 0, 0, 0, 0, 0, 0, 0, 0, 1, 0, 0, 0, 1, 0, 0, 0, 0, 0, 0, 0, 0, 0, 0, 0, 0, 0, 0, 0],

		[0, 0, 0, 0, 0, 0, 0, 1, 0, 0, 0, 1, 0, 0, 0, 1, 0, 0, 0, 1, 0, 0, 0, 1, 0, 0, 0, 1, 0, 0, 0, 1],
		[0, 0, 0, 1, 0, 0, 0, 0, 1, 0, 0, 0, 0, 0, 0, 0, 0, 0, 0, 0, 0, 0, 0, 0, 0, 0, 0, 0, 0, 0, 0, 0],

		[0, 0],
		[0, 0],
		[0, 0],
		[0, 0],
		[0, 0]
	]
}