{
	"name": "Wings Of Piano",
	"source": "Deemo",
	"reference" : "https://www.youtube.com/watch?v=7DhiOubbBTo",
	"image": "images/deemo.jpg",
	"imageWidth": 355,
	"imageHeight": 200,
	"song": "wingsOfPiano.mp3",
	"timeTravel": 2.5,
	"wait": 0,
	"period": 1430,
	"content": [
		[1, 0, 0, 0, 0, 0, 0, 0],
		[3, 0, 0, 0, 0, 0, 0, 0],
		[1, 0, 0, 0, 0, 0, 0, 0],
		[3, 0, 0, 0, 0, 0, 0, 0],
		[1, 0, 0, 0, 0, 0, 0, 0],
		[3, 0, 0, 0, 0, 0, 0, 0],
		[1, 0, 0, 0, 1, 0, 0, 0],
		[1, 0, 0, 0, 1, 0, 0, 0],
		[1, 0, 0, 0, 0, 0, 3, 0],
		[0, 0, 0, 0, 0, 0, 0, 0],
		[1, 0, 0, 0, 0, 0, 3, 0],
		[0, 0, 0, 0, 0, 0, 0, 0],
		[1, 0, 0, 0, 0, 0, 3, 0],
		[1, 0, 0, 0, 0, 0, 3, 0],
		[1, 0, 0, 0, 0, 0, 3, 0],
		[1, 0, 0, 0, 1, 0, 0, 0],
		[1, 0, 0, 1, 0, 0, 0, 0],
		[0, 0, 0, 0, 0, 0, 3, 0],
		[1, 0, 0, 1, 0, 0, 0, 0],
		[0, 0, 0, 0, 0, 0, 3, 0],
		[1, 0, 0, 1, 0, 0, 0, 0],
		[0, 0, 0, 0, 0, 0, 0, 0],
		[0, 0, 0, 0, 0, 0, 0, 0],

		[0, 0, 0, 0, 1, 0, 0, 0],

		[1, 0, 0, 1, 0, 0, 0, 1],
		[0, 0, 0, 3, 0, 0, 0, 0],
		[1, 0, 0, 1, 0, 0, 0, 1],
		[0, 0, 0, 3, 0, 0, 0, 0],

		[1, 0, 0, 1, 0, 0, 0, 0],
		[1, 0, 0, 3, 0, 0, 0, 0],
		[1, 0, 0, 1, 0, 0, 0, 0],
		[0, 1, 0, 0, 3, 0, 0, 0],

		[0, 1, 0, 0, 1, 0, 0, 0],
		[0, 1, 0, 0, 3, 0, 0, 0],
		[0, 1, 0, 0, 1, 0, 0, 0],
		[0, 1, 0, 0, 3, 0, 0, 0],

		[0, 1, 0, 0, 1, 0, 0, 1],
		[0, 0, 0, 3, 0, 0, 0, 1],
		[0, 1, 0, 0, 1, 0, 0, 1],
		[0, 0, 0, 0, 3, 0, 0, 0],

		[3, 0, 0, 0, 0, 0, 3, 0],
		[1, 0, 0, 0, 0, 0, 0, 0],
		[3, 0, 0, 0, 0, 0, 3, 0],
		[1, 0, 0, 0, 1, 0, 0, 0],

		[1, 0, 0, 3, 0, 0, 1, 0],
		[0, 1, 0, 0, 3, 0, 0, 1],
		[0, 0, 1, 0, 0, 3, 0, 0],
		[1, 0, 0, 0, 0, 0, 3, 0],

		[3, 0, 0, 0, 0, 0, 3, 0],
		[1, 0, 0, 0, 0, 0, 0, 0],
		[3, 0, 0, 0, 0, 0, 3, 0],
		[1, 0, 0, 0, 1, 0, 0, 0],

		[1, 0, 1, 0, 3, 0, 1, 0],
		[1, 0, 3, 0, 1, 0, 1, 0],
		[1, 0, 1, 0, 0, 0, 0, 0],
		[0, 0, 1, 0, 3, 0, 1, 0],
		[3, 0, 0, 0, 1, 0, 0, 0],
		[1, 0, 0, 0, 0, 0, 0, 0],

		[0, 0, 0, 0, 0, 0, 0, 0],
		[0, 0, 0, 0, 0, 0, 0, 0],
		[0, 0, 0, 0, 0, 0, 0, 0],
		[0, 0, 0, 0, 0, 0, 0, 0]


	]
}