{
	"name": "Green Hill Zone Theme",
	"source": "Sonic the Hedgehog",
	"reference" : "https://www.youtube.com/watch?v=UEannNh8ihA",
	"image": "images/greenHillZone.jpg",
	"imageWidth": 250,
	"imageHeight": 200,
	"song": "Green_Hill_Zone_Theme.mp3",
	"timeTravel": 3,
	"wait": 0,
	"period": 1600,
	"content": [
		[1, 0, 0, 1, 0, 0, 1, 0],
		[0, 1, 0, 0, 1, 0, 1, 0],
		[1, 0, 0, 1, 0, 0, 1, 0],
		[0, 0, 0, 0, 0, 0, 0, 0],
		[1, 0, 0, 1, 0, 0, 1, 0],
		[1, 0, 0, 1, 0, 0, 1, 0],
		[1, 0, 0, 1, 0, 0, 0, 0],
		[0, 0, 0, 0, 0, 0, 0, 0],
		[0, 0, 0, 0, 1, 1, 0, 1],
		[1, 0, 1, 1, 0, 1, 0, 0],
		[0, 0, 0, 1, 1, 1, 0, 1],
		[1, 0, 1, 1, 0, 1, 0, 0],
		[0, 0, 0, 0, 1, 1, 0, 1],
		[1, 0, 1, 1, 0, 1, 0, 0],
		[0, 0, 0, 1, 1, 1, 0, 1],
		[1, 0, 1, 1, 0, 1, 0, 0],
		[0, 0, 0, 0, 1, 1, 0, 1],
		[1, 0, 1, 1, 0, 1, 0, 0],
		[0, 0, 0, 1, 1, 1, 0, 1],
		[1, 0, 1, 1, 0, 1, 0, 0],
		[0, 0, 0, 0, 1, 1, 0, 1],
		[1, 0, 1, 1, 0, 1, 0, 0],
		[0, 0, 0, 1, 1, 1, 0, 1],
		[1, 0, 1, 1, 0, 1, 0, 0],
		[1, 0, 0, 1, 0, 0, 1, 0],
		[0, 1, 0, 0, 1, 0, 1, 0],
		[1, 0, 0, 1, 0, 0, 1, 0],
		[0, 1, 0, 0, 1, 0, 1, 0],
		[1, 0, 0, 1, 0, 0, 1, 0],
		[0, 1, 0, 0, 1, 0, 1, 0],
		[1, 0, 0, 0, 1, 0, 0, 0],
		[0, 0, 0, 0, 0, 0, 0, 0],
		[0, 0, 0, 0, 1, 1, 0, 1],
		[1, 0, 1, 1, 0, 1, 0, 0],
		[0, 0, 0, 1, 1, 1, 0, 1],
		[1, 0, 1, 1, 0, 1, 0, 0],
		[0, 0, 0, 0, 1, 1, 0, 1],
		[1, 0, 1, 1, 0, 1, 0, 0],
		[0, 0, 0, 1, 1, 1, 0, 1],
		[1, 0, 1, 1, 0, 1, 0, 0],
		[0, 0, 0, 0, 1, 1, 0, 1],
		[1, 0, 1, 1, 0, 1, 0, 0],
		[0, 0, 0, 1, 1, 1, 0, 1],
		[1, 0, 1, 1, 0, 1, 0, 0],
		[0, 0, 0, 0, 1, 1, 0, 1],
		[1, 0, 1, 1, 0, 1, 0, 0],
		[0, 0, 0, 1, 1, 1, 0, 1],
		[1, 0, 1, 1, 0, 1, 0, 0],
		[1, 0, 0, 1, 0, 0, 1, 0],
		[0, 1, 0, 0, 1, 0, 1, 0],
		[1, 0, 0, 1, 0, 0, 1, 0],
		[0, 1, 0, 0, 1, 0, 1, 0],
		[1, 0, 0, 1, 0, 0, 1, 0],
		[0, 1, 0, 0, 1, 0, 1, 0],
		[1, 0, 0, 0, 1, 0, 0, 0],
		[0, 0, 0, 0, 0, 0, 0, 0],
		[0, 0, 0, 0, 1, 1, 0, 1],
		[1, 0, 1, 1, 0, 1, 0, 0],
		[0, 0, 0, 1, 1, 1, 0, 1],
		[1, 0, 1, 1, 0, 1, 0, 0],
		[0, 0, 0, 0, 1, 1, 0, 1],
		[1, 0, 1, 1, 0, 1, 0, 0],
		[0, 0, 0, 1, 1, 1, 0, 1],
		[1, 0, 1, 1, 0, 1, 0, 0],
		[0, 0, 0, 0, 1, 1, 0, 1],
		[1, 0, 1, 1, 0, 1, 0, 0]

	]
}